// 折れる回数
0,1,0,0
@
// ステージの枚数
1
@
// 1つ目のステージの情報
0,0
2,2
1
1
@
//1つ目のステージのタイル情報（1）
0,0
5,5
1,1,1,1,1,0,0,0,0,0
1,1,1,1,1,0,0,0,0,0
1,1,1,2,2,0,0,0,0,0
1,1,1,1,1,0,0,0,0,0
2,1,1,1,1,0,0,0,0,0
@
//1つ目のステージのタイル情報（2）
0,5
5,10
1,2,1,1,1,1,1,1,4,1
1,1,2,1,1,1,1,1,1,1
1,1,1,1,1,2,2,2,2,2
1,1,1,1,1,1,1,1,1,1
1,1,1,1,1,1,1,1,1,1