// 折れる回数
0,0,0,0
@
// ステージの枚数
1
@
// 1つ目のステージの情報
0,0
2,1
1
@
//1つ目のステージのタイル情報（1）
0,0
10,5
1,1,1,1,1,1,1,1,1,1
1,1,1,1,1,1,1,1,1,1
1,4,1,1,1,1,1,1,1,1
1,1,43,1,1,1,1,43,1,3
42,10,23,10,40,42,10,23,10,40
@