// 折れる回数
0,1,0,1
@
// ステージの枚数
1
@
// 2つ目のステージの情報
0,0
1,2
1
1
@
//1つ目のステージのタイル情報（1）
0,0
10,5
1,1,1,1,1,2,2,2,2,2
1,4,1,1,1,1,1,1,1,1
1,1,1,1,1,1,1,1,1,1
2,2,2,2,2,1,1,1,1,1
2,2,2,2,2,2,2,2,2,1
@
//1つ目のステージのタイル情報（2）
0,5
10,5
1,1,2,2,2,2,2,2,1,1
3,1,1,1,1,2,2,2,1,1
2,1,1,1,1,1,1,1,1,2
1,2,1,1,1,1,1,1,1,1
1,1,2,2,2,1,1,1,1,1